

    1111111    1111111
111111001  10001111
100001111111000001
100001     1000001
100001     1000001
10001111 110000011
11111  111  111111