NO ./textures/north_wall.xpm 
SO ./textures/south_wall.xpm
WE ./textures/west_wall.xpm
EA ./textures/east_wall.xpm

F 0, 0, 0
C 255,255,230

        1111111111111111111111111
        1000000000110000000000001
        1011000001110000000000001
        1001000000D00000000000001
111111111011000001110000000000001
100000000011000001110100S11111111
11110111111111011100000000001
11110111111111011101010000001
1100000011010101110000000001
10000000000000000000000000001
1000000000000000001010000001
1100000110010101111101110000111
11110111 1110101 101111010001
11111111 1111111 111111111111