NO ./textures/wall.xpm
SO ./textures/wall.xpm
WE ./textures/wall.xpm
EA ./textures/wall.xpm

F 220   ,100		,0
C 225,30,0

11111
10001
10E01
10001
11111