NO ./textures/wall_2.xpm 
SO ./textures/wall_2.xpm
WE ./textures/wall_2.xpm
EA ./textures/wall_2.xpm

F 0, 0, 0
C 255,255,230

        1111111111111111111111111
        1100000000010000000000001
        10110000011100001D1000001
        1001000001010000000000001
        10010000010100000N0000001
111111111011000001010000000000001
100000000011000001010100011111111
11110111111111011100000000001
11110111111111011101010000001
1100000011010101110000000001
10000000000000000000000000001
10000000000000000000000000001
1000000000000000001010000001
1100000110011101111101110000111
11110111 1000001 101111010001
11111111 1111111 111111111111