NO ./textures/wall.xpm
SO ./textures/wall.xpm
WE ./textures/wall.xpm
EA ./textures/wall.xpm

F 220   ,100		,0
C 225,30,0

11111
1S101        111
11111111111  101
             111