NO ./textures/wall_1.xpm 
SO ./textures/wall_1.xpm
WE ./textures/wall_1.xpm
EA ./textures/wall_1.xpm

F 24, 24,0
C 0,0,0

        1111111111111111111111111
        1000000000010000000000001
        1011000001110000101000001
        1001000001010000000000001
        10010000010100000S0000001
111111111011000001010000000000001
10000000000100000101010001111111
1111D111111111011100000000001
111101111111110111D1110000001
1100000011010101110000111D11
10000000000000000000000000001
10000000000000000000000000001
1000000000000000001010000001
1100000110011101111101110000111
11110111 1000001 101111010001
11111111 1111111 111111111111